R 720 640
NO ./images/NO.xpm
SO ./images/SO.xpm
WE ./images/WE.xpm
EA ./images/EA.xpm

S ./images/ITEM.xpm
F 255,255,0
C 153,102,051

1111 11111
1200 10001
1000100001
10S1000001
1000001001
1020000001
1111011111
   101    
1111011111
1020000201
1111111111
